#P#####################
#.....#.....#.........#
#.###.###.....#####.###
#.#...#...####.#.#....#
#.#######......##..####
#...#...#.#######.#...#
###.#.###.#######.#.###
#.....#...#...###....##
#.#####.#.#######.#####
#.......#....##.......#
#####################E#